n n n n n n n n n n n n n n n n n n n n
n n n n n n n n n n n n n n n n n n n n
n n n n n n n n n n n n n n n n n n n n
n n n 0 n n n n o o o o n n n n 1 n n n
n h h 0 n n n n o o o o n n n n 1 h h n
n h h 0 n n n n o o o o n n n n 1 h h n
n n n 0 n n n n o o o o n n n n 1 n n n
n n n n n n n n n n n n n n n n n n n n
n n n n n n n n n n n n n n n n n n n n
n n n n n n n n n n n n n n n n n n n n
