X X X X X X X X X n n n n X X X X X X X X X
X X X X X X X X X n h h n X X X X X X X X X
X X X X X X X X X n h h n X X X X X X X X X
X X X X X X X X X 0 0 0 0 X X X X X X X X X
X X X X X X X X n n n n n n X X X X X X X X
X X X X X X X n n n n n n n n X X X X X X X
X X X X X X n n n n n n n n n n X X X X X X
X X X X X n n n n n n n n n n n n X X X X X
X X X X n n n n n n n n n n n n n n X X X X
n n n 1 n n n n n o o o o n n n n n 2 n n n
n h h 1 n n n n n o o o o n n n n n 2 h h n
n h h 1 n n n n n o o o o n n n n n 2 h h n
n n n 1 n n n n n o o o o n n n n n 2 n n n
X X X X X n n n n n n n n n n n n n X X X X