n n n n n n n n n n n n n n n n n n n n
n n n n n n n n n n n n n n n n n n n n
n n n n n n n n n n n n n n n n n n n n
n n n p n n n n b b b b n n n n p n n n
n h h p n n n n b b b b n n n n p h h n
n h h p n n n n b b b b n n n n p h h n
n n n p n n n n b b b b n n n n p n n n
n n n n n n n n n n n n n n n n n n n n
n n n n n n n n n n n n n n n n n n n n
n n n n n n n n n n n n n n n n n n n n
