n n n n n n n n n n n n n n n n n n n n
n n n n n n n n n n n n n n n n n n n n
n n n n n n n n n n n n n n n n n n n n
n n n R n n n n b b b b n n n n B n n n
n h h R n n n n b b b b n n n n B h h n
n h h R n n n n b b b b n n n n B h h n
n n n R n n n n b b b b n n n n B n n n
n n n n n n n n n n n n n n n n n n n n
n n n n n n n n n n n n n n n n n n n n
n n n n n n n n n n n n n n n n n n n n
